# Emotionally Intense Songs
Someone Like You - Adele
Walking on Sunshine - Katrina & the Waves
Killing in the Name - Rage Against the Machine
Fast Car - Tracy Chapman
Hurt - Nine Inch Nails (or Johnny Cash)

# Danceable / Club-Oriented Songs
Levitating - Dua Lipa
Music Sounds Better with You - Stardust
Midnight - KÃ¶lsch
Get Down on It - Kool & The Gang
Ye - Burna Boy

# Rock/Alternative
Hotel California - Eagles
Black - Pearl Jam
Take Me Out - Franz Ferdinand
Time - Pink Floyd

# Instrumentals & Cinematic
Adagio for Strings - Samuel Barber
Time - Hans Zimmer
Weightless - Marconi Union
Windowlicker - Aphex Twin

# Lyrical & Storytelling
The Night We Met - Lord Huron
The Story of O.J. - Jay-Z
Motion Sickness - Phoebe Bridgers
Jolene - Dolly Parton

# Bonus: Songs to Trick Your System
Jesus of Suburbia - Green Day
Pumped Up Kicks - Foster the People
Everything in Its Right Place - Radiohead
Spoken Word - Chase & Status ft. George the Poet
